7 8
########
...#...#
##...#..
#.#.##.#
#....#.#
##.#...#
##.#####
6 7  